00000000000000000000000000000000
00001111111111100000000011111000
00001222222222100000000012221000
00001222222222100000000012221000
00001222222222100000000012221000
00001222222222100000000012221000
00001222222222100000000014221000
00001222222222100000000012221000
00001222222222100000000012221000
00001222222232100000000012221000
00001222222222100000000011211000
00001222222222100000000001210000
00001222222222100000000001210000
00001222222222100000000001211110
00001211121111100000000001212210
00001210121000000000000001212210
00001210121000000000000001222210
00001210121111100000000001214210
00001210121122100000000001212210
00001210121122100000000001211110
00001210121124100000000001210000
00001210121124100000000001210000
00001210121122100000000001210000
00001211121122100000000111211100
00001222222222100000000122222100
00001211121124111111111122422100
00001210122222222222222242222100
01111211111122111111111122222100
01222222100122100000000122222100
01222224100122100000000111111100
01111111100111100000000000000000
00000000000000000000000000000000
