00000000000000000000000000000000
00000000000000000000000000000000
00000000000000000000000000000000
00000000000000000000000000000000
00111111111100000000000000000000
00122224222100000000000000000000
00122242222100000000000111111100
00111122111111111111111122222100
00000122222222222222222223222100
00000121111111111111111111111100
00000121000000000000000000000000
00000121000000000000000000000000
00000121000000000000000000000000
00000121000000000000000000000000
00000121000000000000000000000000
00000121000000000000000000000000
00000121000000000000000000000000
00000121000000000000000000000000
00000121000000000000000000000000
00111121111000011111111111110000
00122222221000012222222224210000
00122422221000012222222222210000
00122222221111112422222222210000
00122222222222222422222222410000
00122242221111112222222222210000
00122422221000014242222222210000
00111111111000011111111111110000
00000000000000000000000000000000
00000000000000000000000000000000
00000000000000000000000000000000
00000000000000000000000000000000
00000000000000000000000000000000
