00000000000000000000000000000000
00000000000000000000000000000000
00000000000000011111111000000000
00001111000000012222221000000000
00001241000000012222221000000000
00001221000000012222221000000000
00001221111111112222221000000000
00001222222222224222221000000000
00001221111111112222221000000000
00001221000000122222221000000000
00001221000000122222221000000000
00001111000000122222221000000000
00000000000000122222221000000000
00000000000000122222221000000000
00000000000000122222221000000000
00000000000000122222221000000000
00000000000000121111111000000000
00000000000000121000000000000000
00000000000000121000000000000000
01111100000000121000000000000000
01222100000000121000000000000000
01222100000000121000000000000000
01222100000000121000000000000000
01242111111111121110000000000000
01222222222222222210000000000000
01222111111112224210000000000000
01222100000012222211111111111110
01222100000012222222222222222210
01222100000012222211112222222210
01111100000012222410012222232210
00000000000011111110011111111110
00000000000000000000000000000000
