00000000000000000000000000000000
00111111111000000000000011111100
00122222221000000000000012222100
00122422221000000000000012422100
00124224221111111111111112222100
00122222221222224222222222422100
00142222222222222222111112422100
00122242221211222222100012222100
00111111111211111111100011111100
00000000001210000000000000000000
00000000001210000000000000000000
00000000011211000000000000000000
00000000012221000011111111111100
00000000012221000012222222222100
00000000012421000012222222222100
00000000012421000012222222222100
00000000012221000012222222222100
00000000012221000012222222223100
00000000012221000012222222222100
00000000012241000012222222222100
00000000012211000011111121111100
00000000012210000000000121000000
00000000012210000000000121000000
00000000112210000000000121000000
00000000142210000000000121000000
00000000122210000000000121000000
00000000122210000000000121110000
00000000122211111111111122210000
00000000111222222222222222210000
00000000001111111111111112410000
00000000000000000000000011110000
00000000000000000000000000000000
