00000000000000000000000000000000
01111111100000000000000000000000
01222222100000000000000000000000
01222222100001111100000000000000
01222222111111222111111111110000
01222242222222224222222222210000
01222222111111222111111111211100
01222222100001111100000122242100
01222222100000000000000122222100
01111112100000000000000111121100
00000012100000000000000000121000
00000012100000000000000000121000
00000012100000000000000000121000
00000012100000000000000000121000
00000012100000000000000000121000
00000012100000000000000000121000
00000012100000000000000000121000
00000012100000000000000000121000
00000012100000000000000011121110
00001112110000000000000012222210
00001222210000000000000012222210
00001222210000000000000012222210
00001224210001111111000012222210
00001222210001222241000012222210
00001222211111222421000012322210
00001422222222222221000012222210
00001222211111222221000012222210
00001222210001222421000012222210
00001222210001111111000012222210
00001222210000000000000011111110
00001111110000000000000000000000
00000000000000000000000000000000
